type octile
height 16
width 24
map
@@@@@@@@@@@@@@@@@@@@@@@@
@@@@@@@@@@@@@@@@@@@@@@@@
@@@@@@@@@@@@@@@@@@@@@@@@
@@@@@@@@@@@@@@@@@@@@@@@@
@@@@@@@@@@@@@@@@@@@@@@@@
@@@@@@@@@@@@@@@@@@@@@@@@
@@@@@@@@@@@@@@@@@@@@@@@@
@@@@@@@@@@@@@@@@@@@@@@@@
@@@@@@T@@@@@TT@@@@@@@@@@
@@@@@@@@@@@@@@TT@@@@@@@@
@@@@@@@@@@@@@@@TTT@T@@@@
@@@@@@@@@@@@@@@@@TTTTTTT
@@@@@@@@@@@@@@@@@TTT....
@@@@@@@@@@@@@@@@@@T.....
@@@@@@@@@@@@@@@@@@T.....
@@@@@@@@@@@@@@@@@TT.....
