type octile
height 10
width 10
map
TTTTTTTTTT
TTTTT.T..T
TT.T.T...T
TTTT.....T
T....T...T
T..TT....T
T...T.T..T
TTT.TTT.TT
T.T....T.T
TTTTTTTTTT
